........#.............
................#.....
.........#.#..#.......
......................
#..........#.#.......#
...............#......
....#.................
..#.#....#............
.......#..............
......#...............
...#...#.#...#........
....#..#..#.........#.
.......#..............
...........#..#.......
#...........#.........
...#.......#..........

.....#.#.#.....
.........#.....
.............#.
...#.......#.#.
.#.............
#..............
.#.#...#....#..
.##.#........##
.#........#....
...#.#..#......
......#..#.....